”का	”की
”कॉपर	कॉन्ज्युगेटेड
”नामक	नामक
”ऑक्सीजन	डिस्कव्हरी
रसरनवा	रसार्णव
(१८८५))	(१८८५)
(पीएल	जाता
(रेसुब्लिमे)	मरक्यूरिक
(सर्वश्रेष्ठ	सर्वश्रेष्ठ
१९३२।	१९३२
२६७-२८३	२६७-२८३
७०ॐ	७०वें
९२	९२
आगमन	फार्मास्युटिकल
आजादी	स्वतंत्रता
आत्मनिर्भरता	पूरा
आवश्यकता	परखनलीप्रतिस्पर्धा
आयात	करनेसे
भाग	कोना
भारतीय	भारतीयके
भारत	”भारत
भावना	ज्योत
भी	पतासही
भूल	सुनाई
छोड़नी	सुनी
धाराओं	पाठ्यक्रम
धातु	धात्विक
ध्यान	बिंदुपर
घोश	प्रबल
ईअल्च्हिमिए	अल्केमी
खंड	व्हॉल्यूम
खड़आ	जगहलगातार
खतरा	संकट
खिलाफ	विरुद्ध
खिताब	उपाधि
खो	आशा
खोज”	ऑक्सिजन”
ळेस्	ओरिजिनेस
और	भारतअपनीकारसायनउन्होंने
औरिगिनेस्	द
फैलाया:	हैं:
फैल	बस
फैसला	निर्णय
फिर	मेंपुनःपुन्हः
फ्रांज़	(रसायन
ढंग	पद्धति
शादी	विवाह
शामिल	सहभागीसमावेश
शैक्षणिक	बनने
शोधपत्र:	शोध-पत्र:
श्रोताओं	दर्शकों
शुरू	प्रारंभउपयोग
शुरुआत	आरंभका
था	था।
था	था।गयाउससेविचार
था।	थी।थें।हुई।किया।
था।”	दृष्टिकोण)।”
थी	थाथीजानेतदनुसार
थीसिस	शोध-प्रबंध
थी।	था।है।
थे	ब्रिटिशों
थे।	था।बनाई।दिया।हैं।हुए।
[अमृत	-[अमृत
अ	ए
अब	स्थानीय
अलग	अलग-अलग
अल्च्हिमिस्तेस्	अल्केमिस्टेस
अन्चिएन्स्	ऍन्सिएन्स
अनुत्सुक।	थें।
अपनी	अपनेजिससेकीमें
अपने	अपनाजीवन-यात्रास्वयं
असंतुलन	अनुपात
अस्पष्ट	कठिनाई
अत्यधिक	अत्याधिकवह
अवलोकन	इतिहास
बाद	बाद
बाकी	वाक्य
बारे	काविषय
बधाई	लगाते
बंगाल	बिखरे
बढ़आया	ढ़केला
बदलते	पूर्व
बहुत	खड़एअधिक
बनाई	किए
बनने	करनेडिग्री
बताते	कहते
बिखेरा	कच्चे
ब्रिटिश	अपने
बुनियादी	मूल
चाहिए।	जाए।
चेमी	केमिई
दौरान	महत्त्व
दौरान	समय
दूरदर्शी	तत्कालीन
द	द
दबा	रोक
दबाने	उपयोग
दर्शन	तत्वज्ञान
दवाओं	औषधिओं
दवाओं	औषधिओं
दे	ल
देखा	देखीदेखने
देना	यह
देस्	देस
दृष्टिकोण)।	मार्ग)।
दृष्टिकोण)।”	मिला।”
दिया	गयानष्टरहे
दिया.	अनुत्सुक।
दिया।	हैं।
दिया।”	दी।”
दोहराया	प्रांभ
दोस्त	मित्र
दुनिया	विश्व
एक	”एक(सर्वश्रेष्ठकिसीउदारताउपस्थित
गंवाया	गँवाया
गठन	स्थापित
गया	गया।गे।कीमिलानिकटतम
गया।	गी।हुआ।
गे	गयानहीं
गेशिच्टे	गेशिच्टे
ग्रंथ-सूची	संदर्भग्रंथ-सूची
ग्रेच्स्	ग्रेस
है	हैहै।करके
है)।	थी।
है	मालों
हैं	आवश्यकताहैहैं”होनी
हैं।	है।।
है।	था।थे।इस
ही	रहनेसंकुल
हूं	हूँ
हमें	देने
हिस्सा	भाग
हिस्सों	भागों
हो	मुख्य
होने	आने
हुआ	पीछे
हुई	पंजीकरण
हुए	कियावाला
हुए	थें
इंग्लैंड	कुछ
इस	ध्यानअवसरइसीनिर्भरपुस्तक
इसे	समय
जा	अपनीसकता
जाना	स्थिति
जाने	आत्मनिर्भरताकरने
जाता	होतामेंवाला
जीवनी	आत्मचरित्र
जब	(मांग)
जहां	जहाँ
जरूरतों	आवश्यकताओं
जयकारों	डॉक्टर
जिसमें	उस
जिसे	जोका
जो	दासप्रकृतिवाले
का	बारेगयाकीकेसेवालेविश्वविद्यालय
काल	दौर
कार्यालय	वहाँ
कार्य	सैर
की	ऐसेथोकबारेचाहिए।काकीकी।कुछसाथसभासेउनकीऑफ
की	कहा
की।	आरंभकिया।समझाया।
कच्चे	ने
कहा	है
कलकत्ता	कलकत्ताकोलकाता
कम	केयौगिक
कर	बताचलकी
करना	समझना
करने	आयोजनबतानेदेनेजाने
करती	करताकिया
करते	अनुरोधकरने
के	खरीदतेदहीइच्छाइसकाकीकिएमेंनिराकरणपरपुनःसामर्थ्यसहायतासकेउल्लेखनीययूरोप
केमिकल	”केमिकल
केमिस्ट्री	केमिस्ट्री
किस्सा	उद्धरण
किया	होहुएकीकरताकिएकियाकिया।निर्माणसल्फाइड
किया	किए
किया।	हुए।लिया।
को	थेहँसीकाकिलिएमेंनारेपारदपूर्णतयास्वरूपवे
कोई	भीऔर
कोशिश	प्रयास
कोलकाता-७००००९	कार्यालय
क्रांतिकारी	परोपकारी
कुछ	बहुतइंग्लैंडकारण
लगभग	एकदम
ले	का
लिखते	बताते
लिखे	लिखा
लिए	हेतुकाउद्यमी
लिए।	लिए।”
लोगों	कोव्यक्ति
माल	हजारों
मैग्नीशियम	सल्फेट्स
मौजूदा	विद्यमान
मौजूद	हुएविद्यमान
महान	अलौकिक
महसूस	अनुभवहोना
मॉरिट्ज़	विज्ञान
में	औरबहुतहुआहुएकीकेमिलानिर्माणसेउद्देश्यवाष्पवर्णन
में”	में
मेरे	मेरा
मुझे	विचार
मुखर	बोले
मुलाकात	भेंट
नाजी	नाझी
नाम	अब
नी	नया
ने	इतिहास)काकारणप्रेरणासंख्याओंसेये
नेतृत्व	अध्यक्षता
निबंध”	इंडिया”
निकटतम	सम्मान
निर्भरता	रहने
निर्माण	बँधाईसे
निर्माता	पुस्तक
न्यूजपेपर	समाचारपत्र
ओर	परस्वदेशी
पाठ्यक्रम	पाठ्यक्रम
पाने	दौड़ने
पारा-१	(ई)भी
पारा-२	(ईई)
पैदा	निर्माणप्रदानप्रज्वलित
पीछे	मैं
पूरी	दूसरोंपूर्ण
पूर्व	लिमिटेड
पंजीकरण	उसका
पदोन्नत	पदोन्नत।
पड़एगा	मिली
पड़ने	छोड़कर
पर	खड़आदेशमेंउसऑन
पर	पर
पर।”	ग्रूप”
परिभाषा	उद्योगों
परिवर्तन	वाष्पिकृत
पता	हुई।
पत्र	शोध-पत्र
पेश	प्रस्तुत
प्लाक	प्लाक”
प्लेक	प्लाक
प्रांभ	प्रारंभ
प्रशासन	पदार्थों
प्रदर्शनी	एक्झिबिशनला
प्रकाशित	(रेसुब्लिमे)
प्रकाशित”	प्रकाशित
प्रकार	कारणनेस्वागत
प्रकृति	काकी
प्रतियां	प्रतियाँ
प्रॉक्सीम	प्रॉक्झिम
प्रो.	प्रा.प्राध्यापक
प्रोफेसर	प्राध्यापक
प्रोसीडिंग्स	प्रोसिडिंग्स
डेर	डर
रूप	अबबहुतबिनापरसम्मानउससे
रहती	आते
रहे	रहे।वक्तायोजना
रसायन	रसायन
रसायनज्ञ	वैज्ञानिक
रवैये	व्यवहार
रिकॉर्ड	अभिलेख
साथ	खड़आथीकेकोप्राप्तसे
साथ	अनुसंधानमें
साबित	प्रमाणित
साइंस	साइंस
सामान्य	श्याम
सामर्थ्य	सुप्त
सीखी	हुए
सीखनी	सीखनासीखने
सीखने	सीखना
स्थापना।	की।
स्थिति	बहुत
सभी	प्रत्येक
संभावनाओं	सामर्थ्य
संघनित	ऊर्ध्वपातनित
संश्लिष्टाएँ	संश्लिष्टे
संश्लिष्टे	यौगिक
संश्लिष्टों	यौगिकों
संदर्भ	बारे
संदर्भग्रंथ-सूची	ग्रंथ-सूची
संक्रमण	परिवर्तन
संयुग्मित	कॉपर
सबूत	प्रमाण
सका...	है...
सकता...”	नहीं...”
सकते	आवश्यकता
सकें	क्योंकि
सक्रिय	पुनर्जीवित
सल्फेट्स	मैग्नीशियम
समाज	समाज
समाजसेवक	उद्योगपति
समीक्षा।	समय।
समूह	ऑफ
समय	गौरवजनसभा
समिति	समिति
से	हीकारणकमकेकियाकोकोविड-१९कुछपरपरिवर्तनतकवर्क्स
सृष्टि	निर्माण
स्कूल	विद्यालय
स्कॉट्समैन	स्कॉट्समैन
सोसाइटी	सोसाइटी
सुनी।	दे।
स्वयं	जी
तक	रूप
तरह	आतेकोपूर्णतया
तुलना	अधिक
उदारता	बंगाल
उद्यमी	शैक्षणिक
उद्योगपति	नव-उद्योगपति
उद्योगों	नाम
उजागर	स्पष्ट
उम्र	आयुवायु
उनकी	समझ
उन्हें	होतीवे
उन्होंन	उन्होंने
उपहास	अपनी
उपयोग	शरीर
उस	इस
उसे	बोलना
वाष्पिकृत	जो
वी	१९
वीं	१९वीं
वक्ता	रहे
वर्गीकृत	क्लासिपाइड
विफलता	होने
विशाल	विशाल
विद्यार्थियों	छात्रों
विद्यमान	(बीसीपीडब्ल्यूएल)
विकास	जाना
व्याख्या	ब्यौरामें
व्यापार	ट्रेड्स
व्यक्त	समर्थन
व्यक्ति	दूरदर्शी
टेस्ट-ट्यूब	पुकार
याद	स्मरण
यादें	स्मृतियाँ
यह	”यहयोग्य
योग्य	उपयुक्त
्प्रणाली	प्रणाली
